version=1
14
22
xxxxxxxxxxxxxxxxxxxxxx
xs----------xxx------x
x-x-xx-xx-x-----x--x-x
xxx--x-x-xx-x--xx--x-x
x---x-x---x-x-xxx-x--x
x-xxx---x--x-x----xx-x
x-x-x-xx-x-x-xxxxxxxxx
x------x-------xx----x
x-x-x-xx-x-x-xxxx--x-x
x-----xx-------xx--x-x
x-x-x-xx-x-x-xxxx--x-x
x------x-------xx--x-x
x-x-x-x-x-xx-x----xxex
xxxxxxxxxxxxxxxxxxxxxx