version=1
40
50
xxxxxxxxxxxxxxxxxxxxxxxxxxxxxxxxxxxxxxxxxxxxxxxxxx
x-----------xxxxxx------------xxxxxxxxxx-------s-x
x-xxxxxxx-x-xxx----xxxxxxxxx-------------xxx-xxxxx
x---------x-x---xxxxxxxxxxxx-xxxxxxxxxxx---------x
x-xxxxxxx-x---x-x-x-x-xxx----x-------------------x
x--------sxxx-x-x-x-x-x-x-xxxx-------------------x
xxxxxxxxxxx---x---x-x---x---xx-------------------x
x-------------x-------x-xxx-xx-------------------x
xxxx-xxxxxxxxxx---xxxxxxx---xx-------------------x
xx----xxxxxxxx------------x--x-------------------x
x--xx-------------xxxx-xxxxx-x-------------------x
x-xxxxx-xxxxx-xxx--xxx-xxx---x-------------------x
xxxxxxx----------xxxxx-xxxxxxx-------------------x
xxxxxxxxxxxxxxx-xxx-xxx------x-------------------x
x-----------------x-x--------x-------------------x
x-------------------x-x------x-------------------x
x-----------------x-x-x--------------------------x
x-----------------x-xex--------------------------x
x-------------------x-x--------------------------x
x-----------------x-x-x--------------------------x
x-----------------x---x--------------------------x
x--------------------x---------------------------x
x------------------------------------------------x
x------------------------------------------------x
x------------------------------------------------x
x------------------------------------------------x
x--------------------------------------s---------x
x------------------------------------------------x
x------------------------------------------------x
x------------------------------------------------x
x------------------------------------------------x
x------------------------------------------------x
x------------------------------------------------x
x------------------------------------------------x
x------------------------------------------------x
x------------------------------------------------x
x------------------------------------------------x
x------------------------------------------------x
xs-----------------------------------------------x
xxxxxxxxxxxxxxxxxxxxxxxxxxxxxxxxxxxxxxxxxxxxxxxxxx