version=1
14
30
xxxxxxxxxxxxxxxxxxxxxxxxxxxxxx
------------------xx-----xx---
-------xx-----xx--------------
--xx----------------xx--------
--------xx--------------------
--xx-----------xx---xx--------
--------xx----------------xx--
-----xx-----------------------
----------------xx---xx-------
------------xx-----------xx---
--xx--------------------------
-------xx--------xx-----------
--xx---------xx-----------xx--
xxxxxxxxxxxxxxxxxxxxxxxxxxxxxx